.------------------.
|                  |
|       i          |
| ----------|x     |
| H       O       x|
| ----------|     x|
|-----|            |
|i    |         x  |
|-----|            |
|          i       |
|                 p|
.------------------.
