.------------------.
| H  i             |
|                  |
|                  |
|     O            |
|-----------------x|
|                  |
| --------    |  x |
|  i       i  |  x |
|  .----------.    |
| i            x  p|
.------------------.
