.------------------.
| x       H      x |
|   i        ------|
|--------.         |
|  i     |   i     |
|------  | i       |
|   x    .----.    p
|             |    |
|------.           |
|   O  |           |
|           i  x   |
.------------------.