.------------------.
| H     i        x |
|--------------    |
|                  |
|   ---------------|
|        x         |
|---------------   |
| p|               |
|  |   ------------|
|  |        x   O  |
|           x   i  |
.------------------.