.------------------.
| O                |
|       x          |
|                  |
|----|             |
|p      i          |
|----|       x     |
|                  |
|      x           |
|             x    |
|H                 |
.------------------.
