.------------------.
| x       H      x |
|   i        ------|
|--------.         |
|  i     |         |
|------  | i       |
|   x    .----.    p
|             |    |
|------.           |
|   O  |           |
|              x   |
.------------------.